ステージ02,
2番目のステージ,
N,N,N,N,N,N,N,N,N,N,N,N,N,N
N,N,1,1,1,1,1,N,N,N,N,N,N,N
N,N,1,1,1,1,1,N,N,N,N,N,N,N
N,N,N,N,N,N,N,N,N,N,N,N,N,N
N,N,N,N,N,N,N,N,N,N,N,N,N,N
N,N,N,N,N,N,N,N,N,N,N,N,N,N
N,N,N,N,N,N,N,1,1,1,1,1,1,N
N,N,N,N,N,N,N,1,1,1,1,1,1,N
N,N,N,N,N,N,N,N,N,N,N,N,N,N
N,N,N,N,N,N,N,N,N,N,N,N,N,N
