ステージ05,
５番目のステージ,
N,N,N,N,N,N,N,N,N,N,N,N,N,N
N,N,2,N,",N,2,N,2,N,2,N,N,N
N,N,N,N,N,N,N,N,N,N,N,N,N,N
N,N,N,1,N,3,N,3,N,1,N,1,N,N
N,N,N,N,N,N,N,N,N,N,N,N,N,N
N,N,1,N,1,N,1,N,3,N,1,N,N,N
N,N,N,N,N,N,N,N,N,N,N,N,N,N
N,N,N,4,N,4,N,4,N,4,N,4,N,N
N,N,N,N,N,N,N,N,N,N,N,N,N,N
N,N,N,N,N,N,N,N,N,N,N,N,N,N
