ステージ06,
破壊不可ブロックが発生する,
N,N,N,N,N,N,N,N,N,N,N,N,N,N
N,N,N,N,N,N,N,N,N,N,N,N,N,N
N,N,N,N,N,N,N,N,N,N,N,N,N,N
N,N,N,2,2,3,4,3,2,2,N,N,N,N
N,N,N,I,1,1,1,1,1,I,N,N,N,N
N,N,N,I,1,1,1,1,1,I,N,N,N,N
N,N,N,I,1,1,1,1,1,I,N,N,N,N
N,N,N,I,I,I,I,I,I,I,N,N,N,N
N,N,N,N,N,N,N,N,N,N,N,N,N,N
N,N,N,N,N,N,N,N,N,N,N,N,N,N
