ステージ04,
テストステージ,
N,N,N,N,N,N,N,N,N,N,N,N,N,N
N,2,N,N,N,N,N,N,N,N,N,N,N,N
N,2,N,N,N,N,N,N,N,N,N,N,N,N
N,2,N,N,N,N,N,N,N,N,N,N,N,N
N,2,N,N,N,N,N,N,N,3,3,N,N,N
N,2,N,N,N,N,N,N,3,N,N,3,N,N
N,2,2,2,2,2,N,3,N,N,N,N,N,N
N,N,N,N,N,N,N,3,N,N,1,1,1,N
N,N,N,N,N,N,N,N,3,N,N,3,1,N
N,N,N,N,N,N,N,N,N,3,3,N,1,N
