ステージ03,
HPが存在するブロック発生,
N,N,N,N,N,N,N,N,N,N,N,N,N,N
N,N,N,N,N,N,N,2,2,2,2,2,N,N
N,N,N,N,N,N,N,1,1,1,1,1,N,N
N,N,N,N,N,N,N,N,1,N,N,1,N,N
N,N,N,N,N,N,N,N,N,N,N,1,N,N
N,N,N,N,N,N,N,N,N,N,N,1,N,N
N,N,1,1,1,1,N,N,N,N,N,1,N,N
N,N,2,2,2,2,N,N,N,N,N,2,N,N
N,N,N,N,N,N,N,N,N,N,N,N,N,N
N,N,N,N,N,N,N,N,N,N,N,N,N,N
